{
  "id": 10,
  "name": "Unnamed Level",
  "width": 16,
  "height": 16,
  "grid": [
    "################",
    "                ",
    "          BB    ",
    " #   #######    ",
    "  B             ",
    " ########  B    ",
    "          ###   ",
    "         ##     ",
    "        ##      ",
    "       ##       ",
    "      ##        ",
    "    P##         ",
    "    ##      # # ",
    "B   #      ## # ",
    "B      B  ### #D",
    "############# ##"
  ]
}