{
  "id": 5,
  "name": "Unnamed Level",
  "width": 16,
  "height": 16,
  "grid": [
    "################",
    "                ",
    "                ",
    "                ",
    "                ",
    "B               ",
    "BB  P           ",
    "BBB #    #      ",
    "#####    ## ### ",
    "#####  #### ### ",
    "##### ######### ",
    "##### ######### ",
    "##### #########D",
    "################",
    "################",
    "################"
  ]
}