{
  "id": 7,
  "name": "Unnamed Level",
  "width": 16,
  "height": 16,
  "grid": [
    "################",
    "                ",
    "                ",
    "          ##### ",
    "         #    # ",
    "        ##    # ",
    "       ##     # ",
    "       ##     # ",
    "               D",
    "# ##           #",
    "#######        #",
    "#####  #     BB#",
    "            BBB#",
    "           BBBB#",
    " B P #     BBBB#",
    "################"
  ]
}