{
  "id": 8,
  "name": "Unnamed Level",
  "width": 16,
  "height": 16,
  "grid": [
    "################",
    "                ",
    "           B    ",
    "       ######## ",
    "       #        ",
    "     B #  BB B  ",
    "B   #### #######",
    "BB     #        ",
    "####   #        ",
    "      B#        ",
    "     BB#        ",
    "P  ##### #      ",
    "B ###### #      ",
    "######## #  #   ",
    "######## #  #  D",
    "################"
  ]
}