{
  "id": 2,
  "name": "Unnamed Level",
  "width": 16,
  "height": 16,
  "grid": [
    "################",
    "                ",
    "                ",
    "                ",
    "                ",
    "                ",
    "                ",
    "                ",
    "                ",
    "                ",
    "                ",
    " P              ",
    "##B         ### ",
    "#### #      ###D",
    "#### ###B ######",
    "################"
  ]
}