{
  "id": 4,
  "name": "Unnamed Level",
  "width": 16,
  "height": 16,
  "grid": [
    "################",
    "                ",
    "                ",
    "                ",
    "                ",
    "                ",
    "               D",
    "               #",
    "BP            ##",
    "BB       #   ###",
    "BBBB     ## ####",
    "#####   ### ####",
    "#####  #########",
    "##### ##########",
    "##### ##########",
    "################"
  ]
}