{
  "id": 1,
  "name": "Unnamed Level",
  "width": 16,
  "height": 16,
  "grid": [
    "################",
    "                ",
    "                ",
    "                ",
    "                ",
    "                ",
    "                ",
    "                ",
    "                ",
    "                ",
    "                ",
    "                ",
    "                ",
    "    #      #   D",
    " B P#B     #  ##",
    "################"
  ]
}