{
  "id": 12,
  "name": "Unnamed Level",
  "width": 16,
  "height": 16,
  "grid": [
    "################",
    "              ##",
    "              ##",
    "    ######### ##",
    "B          ## ##",
    "# B      BB## ##",
    "# ###   BBB## ##",
    "#   #  BBBB## ##",
    "#     ####### ##",
    "# P BB ###### ##",
    "# ####   #### ##",
    "     ###   ##   ",
    " B     ##   # # ",
    "###           # ",
    "### # BBB    ##D",
    "################"
  ]
}