{
  "id": 7,
  "name": "Unnamed Level",
  "width": 16,
  "height": 16,
  "grid": [
    "################",
    "                ",
    "        B  B    ",
    "       ######## ",
    "       #        ",
    "     B #  B  B  ",
    "B   #### #######",
    "BB     #        ",
    "####   #        ",
    "      B#        ",
    "     BB#        ",
    "P  ##### #      ",
    "B ###### #      ",
    "######## #  #   ",
    "######## #  #  D",
    "################"
  ]
}