{
  "id": 8,
  "name": "Unnamed Level",
  "width": 16,
  "height": 16,
  "grid": [
    "################",
    "#              #",
    "#        B     #",
    "#      ####### #",
    "#     ######## #",
    "#    #       # #",
    "#B           # #",
    "#BB          # #",
    "####    P    # #",
    "#####   #    # #",
    "#   ## B## B #  ",
    "#   ######## # D",
    "#   ###        #",
    "#B  #          #",
    "#BB          B #",
    "################"
  ]
}