{
  "id": 6,
  "name": "Unnamed Level",
  "width": 16,
  "height": 16,
  "grid": [
    "################",
    "#              #",
    "#         #B   #",
    "#       ###### #",
    "#      ####### #",
    "#     #      # #",
    "#    #       # #",
    "#B      P    # #",
    "####    #    # #",
    "#####   ## B # #",
    "#   ##   ### #  ",
    "#   ### B### # D",
    "#   ########   #",
    "#B  #          #",
    "#BB          B #",
    "################"
  ]
}