{
  "id": 3,
  "name": "Unnamed Level",
  "width": 16,
  "height": 16,
  "grid": [
    "################",
    "                ",
    "                ",
    "                ",
    "                ",
    "                ",
    "                ",
    "                ",
    "                ",
    "                ",
    "B               ",
    "##              ",
    "  #        #    ",
    "   ##      #    ",
    " P     B  B#   D",
    "################"
  ]
}