{
  "id": 9,
  "name": "Unnamed Level",
  "width": 16,
  "height": 16,
  "grid": [
    "################",
    "                ",
    " BBB P          ",
    " ###### #   ### ",
    " #      #     # ",
    " #      #     #D",
    " #      ##    ##",
    " #       ##     ",
    "             BBB",
    " #          BBBB",
    " #BB  #     BBBB",
    "####### ########",
    "####### ########",
    "####### ########",
    "####### ########",
    "################"
  ]
}