{
  "id": 11,
  "name": "Unnamed Level",
  "width": 16,
  "height": 16,
  "grid": [
    "################",
    "                ",
    " P     B B  BB  ",
    " BB   ########  ",
    " ###            ",
    "    #           ",
    "     ########   ",
    "                ",
    "                ",
    "####       #####",
    "          #    D",
    "BB       #     #",
    "###     #   #  #",
    "###         #  #",
    "###         #  #",
    "################"
  ]
}